#,0,1,2,3,4,5,6,7,8,9,A,B,C,
0, , , , , , , , , , , , , ,
1, , , , , , , , , , , , , ,
2,W, ,W,W,W,W,W,W,W,W,W,~, ,
3,W, , , , , , , , , ,W,~, ,
4,W,W,W,W,W,W, ,W,W,W,W,~, ,
5, , , , , ,W, ,W, , , , , ,
6, , , , , ,W,W,W, , , , , ,
7, , , , , , , , , , , , , ,